time,subj_course_id,sec_code,sec_id,prof,available,waitlist,total,enrolled_ct
1717845406732,AAPI 87,A00,627604,Solomon; Amanda Lee Albaniel,20,0,20,0
1717845407260,AAS 10R,A01,525253,Butler; Elizabeth Annette,0,4,34,34
1717845407260,AAS 10R,A02,525264,Butler; Elizabeth Annette,0,2,34,34
1717845407788,AESE 278A,A00,524413,Staff,40,0,40,0
1717845408317,AESE 279A,A00,524414,Staff,40,0,40,0
1717845408843,AIP 197,001,523803,Staff,50,0,50,0
1717845409370,AIP 197DC,001,523804,Hill; Seth J,24,0,32,8
1717845409896,AIP 197P,001,523805,Staff,120,0,120,0
1717845410427,ANAR 100,A00,528893,Fortier; Jana,12,0,20,8
1717845410963,ANAR 104,A01,528895,Tamberino; Anthony Thomas,6,0,25,19
1717845411495,ANAR 116,A00,528903,Shtienberg; Gilad,23,0,30,7
1717845412027,ANAR 120,A00,528904,Garvin; Arianna Christina,10,0,30,20
1717845412552,ANAR 166,A00,528913,Staff,9,0,30,21
1717845413087,ANAR 167,A01,528923,Rivera-Collazo; Isabel C,4,0,10,6
1717845413617,ANBI 100,A00,528985,Marchetto; Maria Carolina,21,0,40,19
1717845414149,ANBI 112,A00,528987,Marchetto; Maria Carolina,0,16,15,15
1717845414681,ANBI 117,A01,529006,Fox; Patrick Keolu Ozer,19,0,40,21
1717845415208,ANBI 120,A00,660614,Non; Amy L,16,0,40,24
1717845416792,ANSC 104,A00,529103,Yeh; Rihan Wen Xin,0,4,25,25
1717845417318,ANSC 121,A00,529107,Sloane; Julia Kathryn,22,0,60,38
1717845417847,ANSC 124,A00,529108,Bialecki; Jon Anthony,17,0,35,18
1717845418374,ANSC 129,A00,529109,Csordas; Thomas J.,1,0,7,6
1717845418906,ANSC 142,A00,529110,Stone; Annika Britt,16,0,45,29
1717845419437,ANSC 148,A00,529111,Walkover; Lillian B,31,0,45,14
1717845419970,ANSC 156,A00,529117,Jenkins; Janis A.,0,10,12,12
1717845420496,ANSC 169,A00,529121,Fortier; Jana,17,0,25,8
1717845421557,ANTH 1,A00,528797,Jassal; Aftab,109,0,150,41
1717845422089,ANTH 2,A01,528799,Wilder; Linnea Lorene,24,0,44,20
1717845422089,ANTH 2,A02,528800,Wilder; Linnea Lorene,41,0,44,3
1717845422089,ANTH 2,A03,528801,Wilder; Linnea Lorene,40,0,44,4
1717845422089,ANTH 2,A04,528802,Wilder; Linnea Lorene,32,0,44,12
1717845422089,ANTH 2,A05,528803,Wilder; Linnea Lorene,41,0,44,3
1717845422089,ANTH 2,A06,528804,Wilder; Linnea Lorene,42,0,44,2
1717845422618,ANTH 10,A00,528805,Stewart; Alexander B,139,0,178,39
1717845423152,ANTH 21,A01,528807,Stone; Annika Britt,17,0,36,19
1717845423152,ANTH 21,A02,528808,Stone; Annika Britt,19,0,36,17
1717845423152,ANTH 21,A03,528809,Stone; Annika Britt,8,0,36,28
1717845423152,ANTH 21,A04,528810,Stone; Annika Britt,26,0,36,10
1717845423152,ANTH 21,A05,528811,Stone; Annika Britt,31,0,36,5
1717845423152,ANTH 21,A06,528812,Stone; Annika Britt,23,0,36,13
1717845423152,ANTH 21,A07,528813,Stone; Annika Britt,27,0,34,7
1717845423152,ANTH 21,B01,528815,Kang; Byung Chu,32,0,36,4
1717845423152,ANTH 21,B02,528816,Kang; Byung Chu,29,0,36,7
1717845423152,ANTH 21,B03,528817,Kang; Byung Chu,31,0,36,5
1717845423152,ANTH 21,B04,528818,Kang; Byung Chu,34,0,36,2
1717845423152,ANTH 21,B05,528849,Kang; Byung Chu,25,0,36,11
1717845423152,ANTH 21,B06,528852,Kang; Byung Chu,32,0,36,4
1717845423684,ANTH 23,A01,528885,Stewart; Alexander B,22,0,26,4
1717845423684,ANTH 23,A02,528886,Stewart; Alexander B,18,0,26,8
1717845423684,ANTH 23,A03,528887,Stewart; Alexander B,18,0,26,8
1717845423684,ANTH 23,A04,528888,Stewart; Alexander B,26,0,26,0
1717845423684,ANTH 23,A05,528889,Stewart; Alexander B,25,0,26,1
1717845423684,ANTH 23,A06,528890,Stewart; Alexander B,23,0,26,3
1717845423684,ANTH 23,A07,528891,Stewart; Alexander B,15,0,22,7
1717845424217,ANTH 87,A00,528892,Varma; Saiba,20,0,20,0
1717845424217,ANTH 87,B00,660469,Jordan; David K.,20,0,20,0
1717845424217,ANTH 87,C00,660552,Jordan; David K.,20,0,20,0
1717845424747,ANTH 101,A01,529162,Staff,9,0,30,21
1717845424747,ANTH 101,A02,529163,Staff,7,0,30,23
1717845424747,ANTH 101,A03,529164,Staff,22,0,30,8
1717845424747,ANTH 101,A04,529177,Staff,18,0,30,12
1717845425282,ANTH 105,A00,529238,Staff,21,0,60,39
1717845425807,ANTH 108,A00,529239,Sloane; Julia Kathryn,3,0,35,32
1717845426858,ANTH 196A,A00,529263,Varma; Saiba,12,0,15,3
1717845427386,ANTH 230,001,698885,Goldstein; Paul S,19,0,20,1
1717845427913,ANTH 263,A00,662024,Non; Amy L,14,0,15,1
1717845428438,ANTH 266,A00,529264,Kang; Byung Chu,13,0,20,7
1717845428962,ANTH 268,A00,529265,Cartwright; Lisa,4,0,5,1
1717845429490,ANTH 273,A00,529266,McKenzie; Kerry V.,5,0,5,0
1717845430019,ANTH 278,A00,529267,Kaiser; Bronwyn Nicole,2,0,10,8
1717845430547,ANTH 280A,A00,529268,Jassal; Aftab,11,0,12,1
1717845431086,ANTH 280D,A00,529269,Rivera-Collazo; Isabel C,9,0,10,1
1717845431614,ANTH 281A,001,698875,Pedersen; David,10,0,10,0
1717845432143,ANTH 284,A00,529277,Brenner; Suzanne A,12,0,12,0
1717845432668,ANTH 285,A00,529278,Algaze; Guillermo,5,0,10,5
1717845433208,ANTH 295,001,698908,Algaze; Guillermo,3,0,3,0
1717845433208,ANTH 295,002,698909,Brenner; Suzanne A,3,0,3,0
1717845433208,ANTH 295,003,699048,Csordas; Thomas J.,3,0,3,0
1717845433208,ANTH 295,004,699074,Fox; Patrick Keolu Ozer,3,0,3,0
1717845433208,ANTH 295,005,699260,Gagneux; Pascal,3,0,3,0
1717845433208,ANTH 295,006,699279,Goldstein; Paul S,3,0,3,0
1717845433208,ANTH 295,007,699280,Hankins; Joseph D.,3,0,3,0
1717845433208,ANTH 295,008,699288,Jassal; Aftab,3,0,3,0
1717845433208,ANTH 295,009,699295,Jenkins; Janis A.,3,0,3,0
1717845433208,ANTH 295,010,699302,Kaiser; Bronwyn Nicole,3,0,3,0
1717845433208,ANTH 295,011,699305,Kang; Byung Chu,3,0,3,0
1717845433208,ANTH 295,012,699316,Marchetto; Maria Carolina,3,0,3,0
1717845433208,ANTH 295,013,699319,Non; Amy L,3,0,3,0
1717845433208,ANTH 295,014,699321,Pedersen; David,3,0,3,0
1717845433208,ANTH 295,015,699322,Rivera-Collazo; Isabel C,3,0,3,0
1717845433208,ANTH 295,016,699325,Varma; Saiba,3,0,3,0
1717845433208,ANTH 295,017,699326,Yeh; Rihan Wen Xin,3,0,3,0
1717845433744,ANTH 296,001,699345,Braswell; Geoffrey E.,3,0,3,0
1717845433744,ANTH 296,002,699349,Marchetto; Maria Carolina,3,0,3,0
1717845433744,ANTH 296,003,699359,Rivera-Collazo; Isabel C,3,0,3,0
1717845433744,ANTH 296,004,699362,Varma; Saiba,3,0,3,0
1717845433744,ANTH 296,005,699397,Algaze; Guillermo,3,0,3,0
1717845433744,ANTH 296,006,699525,Brenner; Suzanne A,3,0,3,0
1717845433744,ANTH 296,007,699582,Csordas; Thomas J.,3,0,3,0
1717845433744,ANTH 296,008,699610,Fox; Patrick Keolu Ozer,3,0,3,0
1717845433744,ANTH 296,009,699612,Gagneux; Pascal,3,0,3,0
1717845433744,ANTH 296,010,699614,Goldstein; Paul S,3,0,3,0
1717845433744,ANTH 296,011,699693,Hankins; Joseph D.,3,0,3,0
1717845433744,ANTH 296,012,699770,Jassal; Aftab,3,0,3,0
1717845433744,ANTH 296,013,699791,Jenkins; Janis A.,3,0,3,0
1717845433744,ANTH 296,014,699811,Kaiser; Bronwyn Nicole,3,0,3,0
1717845433744,ANTH 296,015,699815,Kang; Byung Chu,3,0,3,0
1717845433744,ANTH 296,016,699816,Levy; Thomas E,3,0,3,0
1717845433744,ANTH 296,017,699821,Non; Amy L,3,0,3,0
1717845433744,ANTH 296,018,699847,Pedersen; David,3,0,3,0
1717845433744,ANTH 296,019,699865,Postero; Nancy Grey,3,0,3,0
1717845433744,ANTH 296,020,699877,Semendeferi; Ekaterini,3,0,3,0
1717845433744,ANTH 296,021,700122,Yeh; Rihan Wen Xin,3,0,3,0
1717845434275,ASTR 1,A01,524420,Konopacky; Quinn Morgan,187,0,300,113
1717845434807,ASTR 18,A01,524422,Arnold; Kam S,27,0,30,3
1717845435336,ASTR 20A,A01,524424,Theissen; Christopher Alexander,23,0,50,27
1717845435867,ASTR 101,A01,524426,Burgasser; Adam Jonathan,20,0,30,10
1717845436394,ASTR 120,A01,524429,Tytler; David Robert,43,0,50,7
1717845436924,ASTR 200,A00,688786,Sandstrom; Karin Marie,18,0,20,2
1717845437451,ASTR 202,A00,688788,Diamond; Patrick H,19,0,20,1
1717845437977,ASTR 250,A00,695473,Staff,17,0,20,3
1717845438502,ASTR 251,A00,695474,Staff,17,0,20,3
1717845439028,AUD 236,A00,525265,Harris; Jeffrey Paul,5,0,5,0
1717845439555,AUD 257,A00,525388,Zettner; Erika,13,0,13,0
1717845440085,AUD 271,A00,525390,Zettner; Erika,13,0,13,0
1717845440612,AUD 274,A00,525409,Zettner; Erika,13,0,13,0
1717845441137,AUD 284,A00,525419,Zettner; Erika,13,0,13,0
1717845441661,AUD 291,A00,525438,Zettner; Erika,13,0,13,0
1717845442185,AUD 296,A00,525454,Zettner; Erika,13,0,13,0
1717845442726,AWP 3,001,523808,Staff,12,0,12,0
1717845442726,AWP 3,002,523809,Staff,12,0,12,0
1717845442726,AWP 3,003,523811,Staff,12,0,12,0
1717845442726,AWP 3,004,523813,Staff,11,0,12,1
1717845442726,AWP 3,005,523816,Staff,12,0,12,0
1717845442726,AWP 3,006,523817,Staff,12,0,12,0
1717845442726,AWP 3,007,523821,Staff,12,0,12,0
1717845442726,AWP 3,008,523823,Staff,12,0,12,0
1717845442726,AWP 3,009,523827,Staff,12,0,12,0
1717845442726,AWP 3,010,523828,Staff,12,0,12,0
1717845442726,AWP 3,011,523829,Staff,12,0,12,0
1717845442726,AWP 3,012,523830,Staff,12,0,12,0
1717845442726,AWP 3,013,523832,Staff,11,0,12,1
1717845442726,AWP 3,014,523833,Staff,12,0,12,0
1717845442726,AWP 3,015,523838,Staff,12,0,12,0
1717845442726,AWP 3,016,523839,Staff,12,0,12,0
1717845442726,AWP 3,017,523840,Staff,11,0,12,1
1717845442726,AWP 3,018,523841,Staff,12,0,12,0
1717845442726,AWP 3,019,523842,Staff,12,0,12,0
1717845442726,AWP 3,020,523843,Staff,12,0,12,0
1717845442726,AWP 3,021,523844,Staff,10,0,12,2
1717845442726,AWP 3,022,523845,Staff,12,0,12,0
1717845442726,AWP 3,023,523848,Staff,12,0,12,0
1717845442726,AWP 3,024,523849,Staff,12,0,12,0
1717845442726,AWP 3,025,523850,Staff,12,0,12,0
1717845442726,AWP 3,026,523851,Staff,0,0,0,0
1717845442726,AWP 3,027,523852,Staff,11,0,12,1
1717845442726,AWP 3,028,523853,Staff,0,0,0,0
1717845442726,AWP 3,029,523854,Staff,0,0,0,0
1717845442726,AWP 3,030,523855,Staff,0,0,0,0
1717845442726,AWP 3,031,523856,Staff,0,0,0,0
1717845442726,AWP 3,032,523857,Staff,0,0,0,0
1717845442726,AWP 3,033,523858,Staff,0,0,0,0
1717845442726,AWP 3,034,523859,Staff,0,0,0,0
1717845442726,AWP 3,035,523860,Staff,0,0,0,0
1717845442726,AWP 3,036,523861,Staff,12,0,12,0
1717845442726,AWP 3,037,523868,Staff,12,0,12,0
1717845442726,AWP 3,038,523875,Staff,0,0,0,0
1717845442726,AWP 3,039,523876,Staff,12,0,12,0
1717845442726,AWP 3,040,523877,Staff,0,0,0,0
1717845442726,AWP 3,041,523878,Staff,0,0,0,0
1717845442726,AWP 3,042,523879,Staff,12,0,12,0
1717845442726,AWP 3,043,523880,Staff,12,0,12,0
1717845442726,AWP 3,044,523881,Staff,12,0,12,0
1717845442726,AWP 3,045,523882,Staff,0,0,0,0
1717845442726,AWP 3,046,523883,Staff,12,0,12,0
1717845442726,AWP 3,047,523884,Staff,12,0,12,0
1717845442726,AWP 3,048,523893,Staff,12,0,12,0
1717845442726,AWP 3,049,523894,Staff,12,0,12,0
1717845442726,AWP 3,050,523895,Staff,12,0,12,0
1717845442726,AWP 3,051,523900,Staff,12,0,12,0
1717845442726,AWP 3,052,523902,Staff,12,0,12,0
1717845442726,AWP 3,053,523904,Staff,12,0,12,0
1717845442726,AWP 3,054,523906,Staff,12,0,12,0
1717845442726,AWP 3,055,523907,Staff,12,0,12,0
1717845442726,AWP 3,056,523913,Staff,12,0,12,0
1717845442726,AWP 3,057,523915,Staff,12,0,12,0
1717845442726,AWP 3,058,523947,Staff,12,0,12,0
1717845442726,AWP 3,059,523948,Staff,12,0,12,0
1717845442726,AWP 3,060,523949,Staff,12,0,12,0
1717845442726,AWP 3,061,523950,Staff,12,0,12,0
1717845442726,AWP 3,062,523951,Staff,12,0,12,0
1717845442726,AWP 3,063,523952,Staff,12,0,12,0
1717845442726,AWP 3,064,523953,Staff,12,0,12,0
1717845442726,AWP 3,065,523954,Staff,12,0,12,0
1717845442726,AWP 3,066,523955,Staff,12,0,12,0
1717845442726,AWP 3,067,523956,Staff,11,0,12,1
1717845442726,AWP 3,068,523957,Staff,0,0,0,0
1717845442726,AWP 3,069,523958,Staff,0,0,0,0
1717845442726,AWP 3,070,523959,Staff,0,0,0,0
1717845442726,AWP 3,071,523960,Staff,0,0,0,0
1717845442726,AWP 3,072,523961,Staff,12,0,12,0
1717845442726,AWP 3,073,523988,Staff,12,0,12,0
1717845442726,AWP 3,074,524010,Staff,0,0,0,0
1717845442726,AWP 3,075,524012,Staff,12,0,12,0
1717845442726,AWP 3,076,524015,Staff,0,0,0,0
1717845442726,AWP 3,077,524091,Staff,0,0,0,0
1717845442726,AWP 3,078,524097,Staff,12,0,12,0
1717845442726,AWP 3,079,524178,Staff,12,0,12,0
1717845442726,AWP 3,080,524179,Staff,11,0,12,1
1717845442726,AWP 3,081,524180,Staff,12,0,12,0
1717845442726,AWP 3,082,524181,Staff,12,0,12,0
1717845442726,AWP 3,083,524182,Staff,12,0,12,0
1717845442726,AWP 3,084,524183,Staff,0,0,0,0
1717845442726,AWP 3,085,524184,Staff,0,0,0,0
1717845442726,AWP 3,086,524187,Staff,0,0,0,0
1717845442726,AWP 3,087,524192,Staff,0,0,0,0
1717845442726,AWP 3,088,524195,Staff,0,0,0,0
1717845442726,AWP 3,089,524200,Staff,0,0,0,0
1717845443256,AWP 4A,001,524205,Staff,0,0,0,0
1717845443256,AWP 4A,002,524212,Staff,0,0,0,0
1717845443256,AWP 4A,003,524213,Staff,0,0,0,0
1717845443256,AWP 4A,004,524215,Staff,0,0,0,0
1717845443782,AWP 4B,A00,524243,Staff,0,0,0,12
1717845443782,AWP 4B,B00,524285,Staff,0,0,0,2
1717845444313,BENG 1,A01,529283,Khojah; Reem I,17,0,25,8
1717845444313,BENG 1,A02,529284,Khojah; Reem I,17,0,25,8
1717845444313,BENG 1,A03,529285,Khojah; Reem I,18,0,25,7
1717845444843,BENG 2,A00,529286,Khojah; Reem I,24,0,30,6
1717845445370,BENG 87,A00,654483,Omens; Jeffrey Howard & Mc Culloch; Andrew Douglas,20,0,20,0
1717845445897,BENG 100,A01,529289,Taylor Amos; Alyssa C,40,0,50,10
1717845446430,BENG 110,A01,529291,Mc Culloch; Andrew Douglas,0,0,30,30
1717845446430,BENG 110,A02,529341,Mc Culloch; Andrew Douglas,7,0,30,23
1717845447049,BENG 119A,A01,529344,Taylor Amos; Alyssa C,0,0,30,30
1717845447578,BENG 122A,A01,529369,Cauwenberghs; Gert,25,0,75,50
1717845448102,BENG 126A,A01,529384,Taylor Amos; Alyssa C,19,0,30,11
1717845448631,BENG 127A,A01,529386,Taylor Amos; Alyssa C,27,0,30,3
1717845449160,BENG 128A,A01,529389,Taylor Amos; Alyssa C,29,0,30,1
1717845449686,BENG 129A,A01,660075,Taylor Amos; Alyssa C,29,0,30,1
1717845450219,BENG 133,A01,651374,Mali; Prashant Gulab Ram,9,0,30,21
1717845450746,BENG 135,A00,529414,Contijoch; Francisco,25,0,40,15
1717845451329,BENG 139A,A01,529429,Taylor Amos; Alyssa C,28,0,30,2
1717845451859,BENG 141,A00,529430,Lal; Ratnesh,12,0,40,28
1717845452386,BENG 147A,A01,529434,Taylor Amos; Alyssa C,25,0,30,5
1717845452913,BENG 148A,A01,529455,Taylor Amos; Alyssa C,29,0,30,1
1717845453442,BENG 149A,A01,529498,Taylor Amos; Alyssa C,29,0,30,1
1717845453969,BENG 161A,A01,529506,Fraley; Stephanie I.,4,0,35,31
1717845453969,BENG 161A,A03,529511,Fraley; Stephanie I.,12,0,35,23
1717845454499,BENG 162,A01,529520,Mali; Prashant Gulab Ram,0,2,27,27
1717845454499,BENG 162,A02,529594,Mali; Prashant Gulab Ram,5,0,27,22
1717845455026,BENG 166A,A00,529598,Sah; Robert Lie-Yuan,27,0,60,33
1717845455555,BENG 169A,A01,529668,Taylor Amos; Alyssa C,26,0,30,4
1717845456086,BENG 179A,A01,529678,Taylor Amos; Alyssa C,21,0,30,9
1717845456629,BENG 183,A03,529681,Zhong; Sheng,1,0,120,119
1717845457155,BENG 187B,A00,529682,Taylor Amos; Alyssa C,36,0,170,134
1717845457685,BENG 196,A00,529687,Staff,5,0,5,0
1717845458213,BENG 216,A01,529783,Cauwenberghs; Gert,21,0,60,39
1717845458741,BENG 219,A00,529784,Valdez-Jasso; Daniela & Schoeneberg; Johannes,0,17,0,5
1717845459272,BENG 221,A00,529785,Valdez-Jasso; Daniela,10,0,56,46
1717845459796,BENG 230A,A00,529795,Huang; Xiaohua,17,0,120,103
1717845460328,BENG 241A,A01,529797,Christman; Karen,0,19,50,50
1717845460855,BENG 242,A00,529798,Cai; Shengqiang,0,8,30,30
1717845461382,BENG 247A,A00,529803,Shi; Lingyan,0,0,35,35
1717845461909,BENG 254,A01,529825,Hasty; Jeff M,0,1,50,50
1717845462442,BENG 280A,A00,529826,Liu; Thomas Tao-Ming & McVeigh; Elliot R.,3,0,70,67
1717845462967,BENG 281,A00,529827,Mc Culloch; Andrew Douglas,19,0,110,91
1717845463497,BENG 282,A00,529846,Engler; Adam J.,22,0,110,88
1717845464023,BENG 292,A01,529850,Ross; Camille,20,0,20,0
1717845464549,BENG 294A,A00,529871,King; Kevin R,27,0,50,23
1717845465079,BENG 295,A00,529872,Watson; John Thomas,9999,0,9999,0
1717845465613,BGGN 202,A00,541979,Kadonaga; James T,20,0,60,40
1717845466144,BGGN 204,A00,541980,Shurin; Jonathan,10,0,20,10
1717845466669,BGGN 206A,A00,541982,Bennett; Eric J,48,0,50,2
1717845467203,BGGN 208,A00,618731,Meyer; Justin Raymond & Pillus; Lorraine,63,0,65,2
1717845467735,BGGN 213,A00,541983,Grant; Barry J,26,0,30,4
1717845468261,BGGN 214,A00,541984,Suel; Gurol Mehmet,0,15,40,40
1717845468791,BGGN 227,A00,541986,Schroeder; Julian I,12,0,30,18
1717845469323,BGGN 245,A00,541989,O'Shea; Clodagh & Shaw; Reuben,0,4,35,35
1717845469852,BGGN 249A,A00,541990,Bloodgood; Brenda Laurie,0,12,0,0
1717845470585,BGGN 271,001,663101,Ackerman; Susan,9999,0,9999,0
1717845470585,BGGN 271,002,663133,Akbari; Omar Sultan,9999,0,9999,0
1717845470585,BGGN 271,003,663134,Allen; Nicola J,9998,0,9999,1
1717845470585,BGGN 271,004,663215,Antal; Corina Elena,9999,0,9999,0
1717845470585,BGGN 271,005,663216,Banegas; Matthew Patrick,9999,0,9999,0
1717845470585,BGGN 271,006,663388,Breen; Ellen C.,9998,0,9999,1
1717845470585,BGGN 271,007,663439,Briggs; Steven,9999,0,9999,0
1717845470585,BGGN 271,008,663440,Bui; Jack D,9998,0,9999,1
1717845470585,BGGN 271,009,663495,Busch; Wolfgang,9999,0,9999,0
1717845470585,BGGN 271,010,663501,Caffrey; Conor,9998,0,9999,1
1717845470585,BGGN 271,011,663523,Castle; Michael James,9997,0,9999,2
1717845470585,BGGN 271,012,663577,Chang; John Tzu-yu,9998,0,9999,1
1717845470585,BGGN 271,013,663987,Chen; Ju,9999,0,9999,0
1717845470585,BGGN 271,014,664025,Chen; Xu,9999,0,9999,0
1717845470585,BGGN 271,015,664185,Cheng; Christine Shiang-Ling,9998,0,9999,1
1717845470585,BGGN 271,016,664187,Cheresh; David A.,9998,0,9999,1
1717845470585,BGGN 271,017,664188,Cherqui; Stephanie,9997,0,9999,2
1717845470585,BGGN 271,018,664231,Church; Kellie Breen,9999,0,9999,0
1717845470585,BGGN 271,019,664420,Cleland; Elsa Eleanor,9998,0,9999,1
1717845470585,BGGN 271,020,664449,Cohen; Shiran,9999,0,9999,0
1717845470585,BGGN 271,021,664560,Coufal; Nicole Gabriele,9998,0,9999,1
1717845470585,BGGN 271,022,664606,Crotty Alexander; Laura E,9998,0,9999,1
1717845470585,BGGN 271,023,664768,Daugherty; Matthew Dorton,9999,0,9999,0
1717845470585,BGGN 271,024,665094,De Guglielmo; Giordano,9999,0,9999,0
1717845470585,BGGN 271,025,665100,Dhar; Debanjan,9998,0,9999,1
1717845470585,BGGN 271,026,665144,Doherty; Taylor Alan,9998,0,9999,1
1717845470585,BGGN 271,027,665204,Dore; Kim Bohemie,9997,0,9999,2
1717845470585,BGGN 271,028,665205,Dulawa; Stephanie Carole,9999,0,9999,0
1717845470585,BGGN 271,029,665294,Esko; Jeffrey D.,9999,0,9999,0
1717845470585,BGGN 271,030,665304,Farley; Emma Kristen,9999,0,9999,0
1717845470585,BGGN 271,031,665313,Feldstein; Ariel E,9998,0,9999,1
1717845470585,BGGN 271,032,665314,Fisch; Kathleen Marie,9996,0,9999,3
1717845470585,BGGN 271,033,665470,Friedman; Rick Adam,9998,0,9999,1
1717845470585,BGGN 271,034,665482,Furnari; Frank,9998,0,9999,1
1717845470585,BGGN 271,035,665486,George; Olivier,9998,0,9999,1
1717845470585,BGGN 271,036,665487,Ghosh; Pradipta,9999,0,9999,0
1717845470585,BGGN 271,037,665972,Glasgow; Stacey Marie,9998,0,9999,1
1717845470585,BGGN 271,038,666003,Gleeson; Joseph Gerard,9999,0,9999,0
1717845470585,BGGN 271,039,666510,Golden; James W,9998,0,9999,1
1717845470585,BGGN 271,040,666542,Golden; Susan S.,9998,0,9999,1
1717845470585,BGGN 271,041,666567,Goren; Alon M,9999,0,9999,0
1717845470585,BGGN 271,042,666650,Guatelli; John C,9999,0,9999,0
1717845470585,BGGN 271,043,666664,Guma; Monica,9999,0,9999,0
1717845470585,BGGN 271,044,666746,Gustafsson; Asa Birgitta,9999,0,9999,0
1717845470585,BGGN 271,045,666815,Gutkind; Jorge Silvio,9999,0,9999,0
1717845470585,BGGN 271,046,666844,Hamdoun; Amr,9999,0,9999,0
1717845470585,BGGN 271,047,666865,Hao; Nan,9999,0,9999,0
1717845470585,BGGN 271,048,667035,Holway; David A.,9999,0,9999,0
1717845470585,BGGN 271,049,667372,Huffaker; Alisa,9999,0,9999,0
1717845470585,BGGN 271,050,667525,Sebat; Lilia Mikhailovna,9998,0,9999,1
1717845470585,BGGN 271,051,667526,Ideker; Trey,9998,0,9999,1
1717845470585,BGGN 271,052,667527,Jiang; Qingfei,9998,0,9999,1
1717845470585,BGGN 271,053,667528,Jin; Yishi,9997,0,9999,2
1717845470585,BGGN 271,054,667529,Joiner; William J.,9998,0,9999,1
1717845470585,BGGN 271,055,667553,Ju; Won-Kyu,9998,0,9999,1
1717845470585,BGGN 271,056,667554,Kaech; Susan Michelle,9997,0,9999,2
1717845470585,BGGN 271,057,667693,Karin; Michael,9999,0,9999,0
1717845470585,BGGN 271,058,667709,Kleinfeld; David,9998,0,9999,1
1717845470585,BGGN 271,059,667835,Koffler; Yacov,9999,0,9999,0
1717845470585,BGGN 271,060,668410,Koloski; Miranda Jane,9998,0,9999,1
1717845470585,BGGN 271,061,668521,Komiyama; Takaki,9998,0,9999,1
1717845470585,BGGN 271,062,668552,Kryazhimskiy; Sergey A,9999,0,9999,0
1717845470585,BGGN 271,063,668603,Lawson; Mark Andrew,9999,0,9999,0
1717845470585,BGGN 271,064,668714,Lee; Yun Sok,9999,0,9999,0
1717845470585,BGGN 271,065,668742,Leutgeb; Stefan,9998,0,9999,1
1717845470585,BGGN 271,066,668825,Li; Willis Xiaowei,9998,0,9999,1
1717845470585,BGGN 271,067,668839,Lo; Stanley M.,9998,0,9999,1
1717845470585,BGGN 271,068,668885,Lopez Ramirez; Miguel Alej,9999,0,9999,0
1717845470585,BGGN 271,069,668886,Lu; Pengzhe,9999,0,9999,0
1717845470585,BGGN 271,070,668903,Lykke-Andersen; Jens,9999,0,9999,0
1717845470585,BGGN 271,071,668933,Lyons; Deirdre Colleen,9999,0,9999,0
1717845470585,BGGN 271,072,668951,McConville; Patrick James,9999,0,9999,0
1717845470585,BGGN 271,073,668957,McDonnell; Lisa Marie,9999,0,9999,0
1717845470585,BGGN 271,074,668970,McHugh; Colleen A,9999,0,9999,0
1717845470585,BGGN 271,075,669039,Meharena; Hiruy Sibhatu,9999,0,9999,0
1717845470585,BGGN 271,076,669040,Morris; Gerald P,9998,0,9999,1
1717845470585,BGGN 271,077,669061,Mukamel; Eran A,9999,0,9999,0
1717845470585,BGGN 271,078,669086,Muotri; Alysson,9999,0,9999,0
1717845470585,BGGN 271,079,669102,Muroyama; Andrew David,9997,0,9999,2
1717845470585,BGGN 271,080,669124,Nieh; James Charles,9998,0,9999,1
1717845470585,BGGN 271,081,669201,Niwa; Maho,9999,0,9999,0
1717845470585,BGGN 271,082,669207,O'Donoghue; Anthony John,9999,0,9999,0
1717845470585,BGGN 271,083,669281,Pantham; Priyadarshini,9999,0,9999,0
1717845470585,BGGN 271,084,669384,Parast; Mana,9999,0,9999,0
1717845470585,BGGN 271,085,669385,Perry; Michael William,9999,0,9999,0
1717845470585,BGGN 271,086,669416,Pillus; Lorraine,9998,0,9999,1
1717845470585,BGGN 271,087,669422,Pogliano; Joseph,9998,0,9999,1
1717845470585,BGGN 271,088,669428,Pride; David Tevis,9998,0,9999,1
1717845470585,BGGN 271,089,669434,Pruneda-Paz; Jose L.,9998,0,9999,1
1717845470585,BGGN 271,090,669435,Rana; Tariq,9999,0,9999,0
1717845470585,BGGN 271,091,669436,Rao; Anjana,9998,0,9999,1
1717845470585,BGGN 271,092,669582,Raz; Eyal,9998,0,9999,1
1717845470585,BGGN 271,093,669607,Ren; Bing,9999,0,9999,0
1717845470585,BGGN 271,094,669608,Risbrough; Victoria Blythe,9998,0,9999,1
1717845470585,BGGN 271,095,669609,Rissman; Robert Andrew,9998,0,9999,1
1717845470585,BGGN 271,096,669610,Rose; Noah Hartmann,9999,0,9999,0
1717845470585,BGGN 271,097,669611,Rosenfeld; Michael G,9998,0,9999,1
1717845470585,BGGN 271,098,669612,Saier; Milton H.,9998,0,9999,1
1717845470585,BGGN 271,099,669613,Saltiel; Alan,9997,0,9999,2
1717845470585,BGGN 271,100,669643,Sanchez-Lopez; Elsa,9998,0,9999,1
1717845470585,BGGN 271,101,669644,Sander; Maike,9999,0,9999,0
1717845470585,BGGN 271,102,669645,Schoeneberg; Johannes,9999,0,9999,0
1717845470585,BGGN 271,103,669646,Schroeder; Julian I,9998,0,9999,1
1717845470585,BGGN 271,104,669647,Sen; George L,9998,0,9999,1
1717845470585,BGGN 271,105,669653,Shaner; Nathan C.,9998,0,9999,1
1717845470585,BGGN 271,106,669665,Sheikh; Farah,9999,0,9999,0
1717845470585,BGGN 271,107,669727,Shurin; Jonathan,9999,0,9999,0
1717845470585,BGGN 271,108,669834,Sicklick; Jason Keith,9998,0,9999,1
1717845470585,BGGN 271,109,670014,Sigurdson; Christina,9998,0,9999,1
1717845470585,BGGN 271,110,670033,Simonson; Tatum Sasha Summ,9999,0,9999,0
1717845470585,BGGN 271,111,670054,Smith; David M.,9999,0,9999,0
1717845470585,BGGN 271,112,670116,Steinmetz; Nicole F,9998,0,9999,1
1717845470585,BGGN 271,113,670122,Su; Chih-Ying,9999,0,9999,0
1717845470585,BGGN 271,114,670139,Suel; Gurol Mehmet,9998,0,9999,1
1717845470585,BGGN 271,115,670149,Telese; Francesca,9999,0,9999,0
1717845470585,BGGN 271,116,670150,Thackray; Varykina G.,9999,0,9999,0
1717845470585,BGGN 271,117,670163,Towers; Christina Garlingt,9998,0,9999,1
1717845470585,BGGN 271,118,670164,Troemel; Emily Ruth,9999,0,9999,0
1717845470585,BGGN 271,119,670168,Tye; Kay M,9999,0,9999,0
1717845470585,BGGN 271,120,670187,Valdez-Jasso; Daniela,9998,0,9999,1
1717845470585,BGGN 271,121,670188,Wahlin; Karl Jonas,9997,0,9999,2
1717845470585,BGGN 271,122,670195,Webster; Nicholas J G,9998,0,9999,1
1717845470585,BGGN 271,123,670196,Welsbie; Derek,9999,0,9999,0
1717845470585,BGGN 271,124,670202,Wilkinson; Miles Frome,9999,0,9999,0
1717845470585,BGGN 271,125,670205,Yaksh; Tony L.,9999,0,9999,0
1717845470585,BGGN 271,126,670206,Yang; Jing,9999,0,9999,0
1717845470585,BGGN 271,127,670359,Yeo; Eugene Wei-Ming,9997,0,9999,2
1717845470585,BGGN 271,128,670360,Ying; Wei,9997,0,9999,2
1717845470585,BGGN 271,129,670361,Young; Jared W.,9999,0,9999,0
1717845470585,BGGN 271,130,670362,Zarrinpar; Amir,9999,0,9999,0
1717845470585,BGGN 271,131,670363,Zengler; Karsten B,9997,0,9999,2
1717845470585,BGGN 271,132,670364,Zhang; Dong-Er,9999,0,9999,0
1717845470585,BGGN 271,133,670367,Zhao; Yunde,9998,0,9999,1
1717845470585,BGGN 271,134,670368,Zheng; Ye,9997,0,9999,2
1717845470585,BGGN 271,135,670429,Zuniga; Elina I,9999,0,9999,0
1717845471110,BGGN 272,A00,541994,Lo; Stanley M.,29,0,30,1
1717845471638,BGGN 275,A00,651534,Pogliano; Joseph,0,0,0,0
1717845472165,BGGN 276,A00,695173,Pogliano; Joseph,0,0,0,0
1717845472693,BGGN 295,A00,541995,Tour; Ella,0,3,0,0
1717845473218,BGJC 204,A00,542000,Lu; Li-Fan & Chang; John Tzu-yu,9984,0,9999,15
1717845473746,BGJC 215,A00,542001,Owens; Melinda Tsao-Ying & Tour; Ella,9,0,10,1
1717845474351,BGRD 200,001,677482,Ackerman; Susan,9999,0,9999,0
1717845474351,BGRD 200,002,677483,Akbari; Omar Sultan,9999,0,9999,0
1717845474351,BGRD 200,003,677486,Allen; Eric,9999,0,9999,0
1717845474351,BGRD 200,004,677487,Allen; Nicola J,9998,0,9999,1
1717845474351,BGRD 200,005,677488,Amaro; Rommie E,9999,0,9999,0
1717845474351,BGRD 200,006,677489,Antal; Corina Elena,9999,0,9999,0
1717845474351,BGRD 200,007,677490,Augustine; Vineet,9998,0,9999,1
1717845474351,BGRD 200,008,677491,Ayres; Janelle Samantha,9998,0,9999,1
1717845474351,BGRD 200,009,677492,Banegas; Matthew Patrick,9999,0,9999,0
1717845474351,BGRD 200,010,677493,Barton; Andrew David,9999,0,9999,0
1717845474351,BGRD 200,011,677494,Benna; Marcus K,9999,0,9999,0
1717845474351,BGRD 200,012,677495,Bennett; Eric J,9999,0,9999,0
1717845474351,BGRD 200,013,677496,Bloodgood; Brenda Laurie,9999,0,9999,0
1717845474351,BGRD 200,014,677497,Breen; Ellen C.,9998,0,9999,1
1717845474351,BGRD 200,015,677498,Briggs; Steven,9999,0,9999,0
1717845474351,BGRD 200,016,677499,Bui; Jack D,9998,0,9999,1
1717845474351,BGRD 200,017,677500,Busch; Wolfgang,9999,0,9999,0
1717845474351,BGRD 200,018,677501,Caffrey; Conor,9998,0,9999,1
1717845474351,BGRD 200,019,677502,Callaway; Edward M,9998,0,9999,1
1717845474351,BGRD 200,020,677503,Castle; Michael James,9999,0,9999,0
1717845474351,BGRD 200,021,677504,Chaim; Isaac,9999,0,9999,0
1717845474351,BGRD 200,022,677505,Chang; John Tzu-yu,9998,0,9999,1
1717845474351,BGRD 200,023,677506,Chen; Ju,9999,0,9999,0
1717845474351,BGRD 200,024,677507,Chen; Xu,9999,0,9999,0
1717845474351,BGRD 200,025,677508,Cheng; Christine Shiang-Ling,9998,0,9999,1
1717845474351,BGRD 200,026,677509,Cheresh; David A.,9998,0,9999,1
1717845474351,BGRD 200,027,677511,Cherqui; Stephanie,9997,0,9999,2
1717845474351,BGRD 200,028,677512,Cho; Yoshitake,9999,0,9999,0
1717845474351,BGRD 200,029,677513,Church; Kellie Breen,9999,0,9999,0
1717845474351,BGRD 200,030,677514,Cleland; Elsa Eleanor,9996,0,9999,3
1717845474351,BGRD 200,031,677515,Cohen; Shiran,9999,0,9999,0
1717845474351,BGRD 200,032,677516,Cook-Andersen; Heidi Leigh,9999,0,9999,0
1717845474351,BGRD 200,033,677517,Cooke; James Edward,9999,0,9999,0
1717845474351,BGRD 200,034,677518,Cooper; Kimberly Lynn,9999,0,9999,0
1717845474351,BGRD 200,035,677519,Coufal; Nicole Gabriele,9998,0,9999,1
1717845474351,BGRD 200,036,677520,Crotty Alexander; Laura E,9998,0,9999,1
1717845474351,BGRD 200,037,677521,Daugherty; Matthew Dorton,9996,0,9999,3
1717845474351,BGRD 200,038,677522,De Guglielmo; Giordano,9999,0,9999,0
1717845474351,BGRD 200,039,677523,De Silva; Shermin,9998,0,9999,1
1717845474351,BGRD 200,040,677525,Desai; Arshad,9998,0,9999,1
1717845474351,BGRD 200,041,677526,Dhar; Debanjan,9998,0,9999,1
1717845474351,BGRD 200,042,677527,Dickinson; Alexandra Jazz,9999,0,9999,0
1717845474351,BGRD 200,043,677528,Dixon; Jesse,9999,0,9999,0
1717845474351,BGRD 200,044,677529,Doherty; Taylor Alan,9998,0,9999,1
1717845474351,BGRD 200,045,677540,Dore; Kim Bohemie,9997,0,9999,2
1717845474351,BGRD 200,046,677541,Dulawa; Stephanie Carole,9999,0,9999,0
1717845474351,BGRD 200,047,677542,Ecker; Joseph R,9997,0,9999,2
1717845474351,BGRD 200,048,677834,Engle; Dannielle D,9997,0,9999,2
1717845474351,BGRD 200,049,677879,Ernst; Andreas,9996,0,9999,3
1717845474351,BGRD 200,050,678041,Esko; Jeffrey D.,9999,0,9999,0
1717845474351,BGRD 200,051,678042,Farley; Emma Kristen,9999,0,9999,0
1717845474351,BGRD 200,052,678043,Feldstein; Ariel E,9998,0,9999,1
1717845474351,BGRD 200,053,678044,Fisch; Kathleen Marie,9996,0,9999,3
1717845474351,BGRD 200,054,678045,Friedman; Rick Adam,9998,0,9999,1
1717845474351,BGRD 200,055,678046,Furnari; Frank,9998,0,9999,1
1717845474351,BGRD 200,056,678047,Gage; Fred H,9999,0,9999,0
1717845474351,BGRD 200,057,678142,George; Monique Leana,9999,0,9999,0
1717845474351,BGRD 200,058,678143,George; Olivier,9998,0,9999,1
1717845474351,BGRD 200,059,678144,Ghosh; Pradipta,9999,0,9999,0
1717845474351,BGRD 200,060,678145,Glasgow; Stacey Marie,9998,0,9999,1
1717845474351,BGRD 200,061,678146,Glass; Christopher,9999,0,9999,0
1717845474351,BGRD 200,062,678147,Gleeson; Joseph Gerard,9999,0,9999,0
1717845474351,BGRD 200,063,678148,Golden; James W,9998,0,9999,1
1717845474351,BGRD 200,064,678149,Golden; Susan S.,9998,0,9999,1
1717845474351,BGRD 200,065,678150,Goldrath; Ananda,9999,0,9999,0
1717845474351,BGRD 200,066,678151,Goren; Alon M,9999,0,9999,0
1717845474351,BGRD 200,067,678152,Guatelli; John C,9999,0,9999,0
1717845474351,BGRD 200,068,678153,Guma; Monica,9999,0,9999,0
1717845474351,BGRD 200,069,678154,Gustafsson; Asa Birgitta,9999,0,9999,0
1717845474351,BGRD 200,070,678155,Gutkind; Jorge Silvio,9998,0,9999,1
1717845474351,BGRD 200,071,678156,Hamdoun; Amr,9999,0,9999,0
1717845474351,BGRD 200,072,678157,Hampton; Randolph Y.,9998,0,9999,1
1717845474351,BGRD 200,073,678158,Hao; Nan,9998,0,9999,1
1717845474351,BGRD 200,074,678159,Hargreaves; Diana Clare,9997,0,9999,2
1717845474351,BGRD 200,075,678160,Hasty; Jeff M,9999,0,9999,0
1717845474351,BGRD 200,076,678161,Hollern; Daniel Patrick,9999,0,9999,0
1717845474351,BGRD 200,077,678162,Holway; David A.,9998,0,9999,1
1717845474351,BGRD 200,078,678163,Huffaker; Alisa,9998,0,9999,1
1717845474351,BGRD 200,079,678164,Hui; Enfu,9998,0,9999,1
1717845474351,BGRD 200,080,678165,Hwa; Terence T.,9999,0,9999,0
1717845474351,BGRD 200,081,678166,Sebat; Lilia Mikhailovna,9998,0,9999,1
1717845474351,BGRD 200,082,678167,Ideker; Trey,9998,0,9999,1
1717845474351,BGRD 200,083,678168,Jackrel; Sara,9998,0,9999,1
1717845474351,BGRD 200,084,678169,Jiang; Qingfei,9998,0,9999,1
1717845474351,BGRD 200,085,678170,Jin; Yishi,9996,0,9999,3
1717845474351,BGRD 200,086,678171,Joiner; William J.,9998,0,9999,1
1717845474351,BGRD 200,087,678172,Ju; Won-Kyu,9998,0,9999,1
1717845474351,BGRD 200,088,678173,Jun; Suckjoon,9998,0,9999,1
1717845474351,BGRD 200,089,678174,Kadonaga; James T,9999,0,9999,0
1717845474351,BGRD 200,090,678175,Kaech; Susan Michelle,9995,0,9999,4
1717845474351,BGRD 200,091,678176,Karin; Michael,9999,0,9999,0
1717845474351,BGRD 200,092,678177,Kleinfeld; David,9998,0,9999,1
1717845474351,BGRD 200,093,678178,Knight; Robin,9998,0,9999,1
1717845474351,BGRD 200,094,678179,Koffler; Yacov,9999,0,9999,0
1717845474351,BGRD 200,095,678180,Koloski; Miranda Jane,9998,0,9999,1
1717845474351,BGRD 200,096,678181,Komiyama; Takaki,9996,0,9999,3
1717845474351,BGRD 200,097,678182,Kosuri; Pallav,9997,0,9999,2
1717845474351,BGRD 200,098,678183,Kronenberg; Mitchell E.,9999,0,9999,0
1717845474351,BGRD 200,099,678184,Kryazhimskiy; Sergey A,9999,0,9999,0
1717845474351,BGRD 200,100,678185,Kurle; Carolyn M.,9999,0,9999,0
1717845474351,BGRD 200,101,678186,Law; Julie A,9999,0,9999,0
1717845474351,BGRD 200,102,678187,Lawson; Mark Andrew,9999,0,9999,0
1717845474351,BGRD 200,103,678190,Lee; Kuo Fen,9999,0,9999,0
1717845474351,BGRD 200,104,678191,Lee; Yun Sok,9999,0,9999,0
1717845474351,BGRD 200,105,678192,Leutgeb; Jill K.,9999,0,9999,0
1717845474351,BGRD 200,106,678193,Leutgeb; Stefan,9997,0,9999,2
1717845474351,BGRD 200,107,678194,Li; Willis Xiaowei,9998,0,9999,1
1717845474351,BGRD 200,108,678195,Lim; Byungkook,9997,0,9999,2
1717845474351,BGRD 200,109,678228,Lo; Stanley M.,9998,0,9999,1
1717845474351,BGRD 200,110,678229,Looger; Loren Lee,9999,0,9999,0
1717845474351,BGRD 200,111,678230,Lopez Ramirez; Miguel Alej,9999,0,9999,0
1717845474351,BGRD 200,112,678231,Lovett-Barron; Matthew Rod,9997,0,9999,2
1717845474351,BGRD 200,113,678233,Lu; Li-Fan,9998,0,9999,1
1717845474351,BGRD 200,114,678234,Lu; Pengzhe,9999,0,9999,0
1717845474351,BGRD 200,115,678235,Lykke-Andersen; Jens,9997,0,9999,2
1717845474351,BGRD 200,116,678236,Lyons; Deirdre Colleen,9999,0,9999,0
1717845474351,BGRD 200,117,678237,Lyumkis; Dmitry Evgenievich,9997,0,9999,2
1717845474351,BGRD 200,118,678238,Madigan; Cressida Ariana,9999,0,9999,0
1717845474351,BGRD 200,119,678239,Manor; Uri,9999,0,9999,0
1717845474351,BGRD 200,120,678240,Mayfield; Stephen P.,9998,0,9999,1
1717845474351,BGRD 200,121,678241,McConville; Patrick James,9999,0,9999,0
1717845474351,BGRD 200,122,678242,McDonnell; Lisa Marie,9999,0,9999,0
1717845474351,BGRD 200,123,678243,McHugh; Colleen A,9999,0,9999,0
1717845474351,BGRD 200,124,678244,Meharena; Hiruy Sibhatu,9999,0,9999,0
1717845474351,BGRD 200,125,678245,Meyer; Justin Raymond,9998,0,9999,1
1717845474351,BGRD 200,126,678246,Morris; Gerald P,9998,0,9999,1
1717845474351,BGRD 200,127,678247,Mukamel; Eran A,9999,0,9999,0
1717845474351,BGRD 200,128,678248,Muotri; Alysson,9999,0,9999,0
1717845474351,BGRD 200,129,678249,Muroyama; Andrew David,9999,0,9999,0
1717845474351,BGRD 200,130,678250,Murre; Cornelis,9999,0,9999,0
1717845474351,BGRD 200,131,678251,Neal; Sonya E,9998,0,9999,1
1717845474351,BGRD 200,132,678252,Nieh; James Charles,9998,0,9999,1
1717845474351,BGRD 200,133,678253,Nimmerjahn; Axel,9998,0,9999,1
1717845474351,BGRD 200,134,678254,Niwa; Maho,9999,0,9999,0
1717845474351,BGRD 200,135,678255,Nizet; Victor F.,9998,0,9999,1
1717845474351,BGRD 200,136,678256,O'Donoghue; Anthony John,9999,0,9999,0
1717845474351,BGRD 200,137,678257,Oegema; Karen,9999,0,9999,0
1717845474351,BGRD 200,138,678258,O'Shea; Clodagh,9999,0,9999,0
1717845474351,BGRD 200,139,678259,Panda; Satchidananda,9999,0,9999,0
1717845474351,BGRD 200,140,678260,Pantham; Priyadarshini,9999,0,9999,0
1717845474351,BGRD 200,141,678261,Parast; Mana,9999,0,9999,0
1717845474351,BGRD 200,142,678262,Pasquinelli; Amy,9998,0,9999,1
1717845474351,BGRD 200,143,678263,Pekkurnaz Banghart; Gulcin,9999,0,9999,0
1717845474351,BGRD 200,144,678264,Perry; Michael William,9997,0,9999,2
1717845474351,BGRD 200,145,678265,Pfaff; Samuel,9999,0,9999,0
1717845474351,BGRD 200,146,678266,Pillus; Lorraine,9998,0,9999,1
1717845474351,BGRD 200,147,678267,Pogliano; Joseph,9998,0,9999,1
1717845474351,BGRD 200,148,678268,Pogliano; Kit J.,9997,0,9999,2
1717845474351,BGRD 200,149,678269,Pride; David Tevis,9998,0,9999,1
1717845474351,BGRD 200,150,678270,Pruneda-Paz; Jose L.,9998,0,9999,1
1717845474351,BGRD 200,151,678271,Ramanan; Deepshika,9999,0,9999,0
1717845474351,BGRD 200,152,678272,Rana; Tariq,9999,0,9999,0
1717845474351,BGRD 200,153,678273,Rao; Anjana,9998,0,9999,1
1717845474351,BGRD 200,154,678275,Raz; Eyal,9998,0,9999,1
1717845474351,BGRD 200,155,678276,Reck-Peterson; Samara L,9997,0,9999,2
1717845474351,BGRD 200,156,678277,Ren; Bing,9999,0,9999,0
1717845474351,BGRD 200,157,678278,Rennison; Diana,9999,0,9999,0
1717845474351,BGRD 200,158,678279,Rifkin; Scott,9999,0,9999,0
1717845474351,BGRD 200,159,678280,Risbrough; Victoria Blythe,9999,0,9999,0
1717845474351,BGRD 200,160,678281,Rissman; Robert Andrew,9998,0,9999,1
1717845474351,BGRD 200,161,678282,Rivera; Fabian Chavez,9999,0,9999,0
1717845474351,BGRD 200,162,678283,Rose; Noah Hartmann,9999,0,9999,0
1717845474351,BGRD 200,163,678284,Rosenfeld; Michael G,9998,0,9999,1
1717845474351,BGRD 200,164,678285,Russell; Alistair B,9998,0,9999,1
1717845474351,BGRD 200,165,678286,Saier; Milton H.,9998,0,9999,1
1717845474351,BGRD 200,166,678287,Saltiel; Alan,9998,0,9999,1
1717845474351,BGRD 200,167,678288,Sanchez-Lopez; Elsa,9998,0,9999,1
1717845474351,BGRD 200,168,678289,Sander; Maike,9999,0,9999,0
1717845474351,BGRD 200,169,678290,Saphire; Erica Ollmann,9999,0,9999,0
1717845474351,BGRD 200,170,678291,Schenk; Simon,9999,0,9999,0
1717845474351,BGRD 200,171,678292,Schoeneberg; Johannes,9999,0,9999,0
1717845474351,BGRD 200,172,678293,Schroeder; Julian I,9998,0,9999,1
1717845474351,BGRD 200,173,678294,Sen; George L,9998,0,9999,1
1717845474351,BGRD 200,174,678295,Shah; Sameer B,9999,0,9999,0
1717845474351,BGRD 200,175,678296,Shaner; Nathan C.,9998,0,9999,1
1717845474351,BGRD 200,176,678297,Shaw; Reuben,9998,0,9999,1
1717845474351,BGRD 200,177,678298,Sheikh; Farah,9999,0,9999,0
1717845474351,BGRD 200,178,678299,Shurin; Jonathan,9999,0,9999,0
1717845474351,BGRD 200,179,678300,Sicklick; Jason Keith,9998,0,9999,1
1717845474351,BGRD 200,180,678301,Signer; Robert,9999,0,9999,0
1717845474351,BGRD 200,181,678302,Sigurdson; Christina,9998,0,9999,1
1717845474351,BGRD 200,182,678303,Simonson; Tatum Sasha Summ,9999,0,9999,0
1717845474351,BGRD 200,183,678304,Smith; David M.,9999,0,9999,0
1717845474351,BGRD 200,184,678305,Soncin; Francesca,9999,0,9999,0
1717845474351,BGRD 200,185,678306,Steinmetz; Nicole F,9998,0,9999,1
1717845474351,BGRD 200,186,678307,Su; Chih-Ying,9999,0,9999,0
1717845474351,BGRD 200,187,678308,Suel; Gurol Mehmet,9997,0,9999,2
1717845474351,BGRD 200,188,678309,Sun; Xin,9997,0,9999,2
1717845474351,BGRD 200,189,678310,Telese; Francesca,9998,0,9999,1
1717845474351,BGRD 200,190,678311,Thackray; Varykina G.,9999,0,9999,0
1717845474351,BGRD 200,191,678312,Towers; Christina Garlingt,9999,0,9999,0
1717845474351,BGRD 200,192,678313,Traver; David,9999,0,9999,0
1717845474351,BGRD 200,193,678314,Troemel; Emily Ruth,9999,0,9999,0
1717845474351,BGRD 200,194,678315,Tye; Kay M,9999,0,9999,0
1717845474351,BGRD 200,195,678316,Valdez-Jasso; Daniela,9999,0,9999,0
1717845474351,BGRD 200,196,678317,Vijayanand; Pandurangan,9998,0,9999,1
1717845474351,BGRD 200,197,678318,Villa Rodriguez; Elizabeth,9999,0,9999,0
1717845474351,BGRD 200,198,678319,Wahlin; Karl Jonas,9998,0,9999,1
1717845474351,BGRD 200,199,678320,Wang; Jean Yin Jen,9999,0,9999,0
1717845474351,BGRD 200,200,678321,Webster; Nicholas J G,9999,0,9999,0
1717845474351,BGRD 200,201,678322,Welsbie; Derek,9999,0,9999,0
1717845474351,BGRD 200,202,678323,Wildonger; Jill Cathleen,9998,0,9999,1
1717845474351,BGRD 200,203,678324,Wilkinson; Miles Frome,9999,0,9999,0
1717845474351,BGRD 200,204,678325,Winzeler; Elizabeth A,9998,0,9999,1
1717845474351,BGRD 200,205,678326,Yaksh; Tony L.,9999,0,9999,0
1717845474351,BGRD 200,206,678327,Yang; Jing,9999,0,9999,0
1717845474351,BGRD 200,207,678328,Yelon; Deborah,9999,0,9999,0
1717845474351,BGRD 200,208,678329,Yeo; Eugene Wei-Ming,9997,0,9999,2
1717845474351,BGRD 200,209,678330,Ying; Wei,9998,0,9999,1
1717845474351,BGRD 200,210,678331,Young; Jared W.,9999,0,9999,0
1717845474351,BGRD 200,211,678332,Zarrinpar; Amir,9999,0,9999,0
1717845474351,BGRD 200,212,678333,Zengler; Karsten B,9997,0,9999,2
1717845474351,BGRD 200,213,678334,Zhang; Dong-Er,9999,0,9999,0
1717845474351,BGRD 200,214,678335,Zhao; Yunde,9999,0,9999,0
1717845474351,BGRD 200,215,678336,Zheng; Binhai,9999,0,9999,0
1717845474351,BGRD 200,216,678337,Zheng; Ye,9996,0,9999,3
1717845474351,BGRD 200,217,678338,Zuniga; Elina I,9998,0,9999,1
1717845474879,BGSE 200,A00,542003,Tour; Ella & Petrie; Katherine Lynn,9991,0,9999,8
1717845475405,BGSE 205,A00,542005,Bennett; Eric J,36,0,50,14
1717845475405,BGSE 205,B00,542006,Bennett; Eric J,44,0,50,6
1717845475405,BGSE 205,C00,542007,Bennett; Eric J,32,0,50,18
1717845475405,BGSE 205,D00,542009,Bennett; Eric J,33,0,50,17
1717845475405,BGSE 205,E00,542011,Bennett; Eric J,34,0,50,16
1717845475945,BIBC 102,A01,641606,Coleman; Aaron B.,0,8,44,44
1717845475945,BIBC 102,A02,641613,Coleman; Aaron B.,0,10,44,44
1717845475945,BIBC 102,A03,641616,Coleman; Aaron B.,0,8,44,44
1717845475945,BIBC 102,A04,641622,Coleman; Aaron B.,0,8,44,44
1717845475945,BIBC 102,B01,641627,Rivera; Fabian Chavez,0,11,44,44
1717845475945,BIBC 102,B02,641628,Rivera; Fabian Chavez,0,10,44,44
1717845475945,BIBC 102,B03,641637,Rivera; Fabian Chavez,0,10,44,44
1717845475945,BIBC 102,B04,641680,Rivera; Fabian Chavez,0,13,44,44
1717845476482,BIBC 103,A01,540288,Grossman; Emily N,0,7,24,24
1717845476482,BIBC 103,A02,540289,Grossman; Emily N,0,7,24,24
1717845476482,BIBC 103,B01,540292,Grossman; Emily N,0,8,24,24
1717845476482,BIBC 103,B02,540293,Grossman; Emily N,0,8,24,24
1717845476482,BIBC 103,C01,540316,Burg; Michael,0,4,24,24
1717845476482,BIBC 103,C02,540318,Burg; Michael,0,3,24,24
1717845476482,BIBC 103,D01,540348,Burg; Michael,0,2,24,24
1717845476482,BIBC 103,D02,540350,Burg; Michael,0,2,24,24
1717845477015,BICD 100,A01,641681,Day; Christopher D,0,7,52,52
1717845477015,BICD 100,A02,641689,Day; Christopher D,0,5,52,52
1717845477015,BICD 100,A03,641690,Day; Christopher D,0,4,52,52
1717845477015,BICD 100,A04,641692,Day; Christopher D,0,4,52,52
1717845477015,BICD 100,B01,641698,Cooper; Andrew Michael,0,13,52,52
1717845477015,BICD 100,B02,641702,Cooper; Andrew Michael,0,12,52,52
1717845477015,BICD 100,B03,641703,Cooper; Andrew Michael,0,9,52,52
1717845477015,BICD 100,B04,641716,Cooper; Andrew Michael,0,11,52,52
1717845477015,BICD 100,C01,639863,Rusert; Jessica Marie,0,4,52,52
1717845477015,BICD 100,C02,639869,Rusert; Jessica Marie,0,3,52,52
1717845477015,BICD 100,C03,639873,Rusert; Jessica Marie,0,0,52,52
1717845477015,BICD 100,C04,640011,Rusert; Jessica Marie,15,0,52,37
1717845477543,BICD 110,A01,540355,Kiger; Amy,10,0,73,63
1717845477543,BICD 110,A02,540360,Kiger; Amy,36,0,73,37
1717845477543,BICD 110,A03,540362,Kiger; Amy,34,0,73,39
1717845477543,BICD 110,A04,540364,Kiger; Amy,40,0,73,33
1717845478069,BICD 140,A01,540366,Zuniga; Elina I,3,0,49,46
1717845478069,BICD 140,A02,540367,Zuniga; Elina I,31,0,49,18
1717845478069,BICD 140,A03,540368,Zuniga; Elina I,24,0,49,25
1717845478069,BICD 140,A04,540369,Zuniga; Elina I,17,0,49,32
1717845478601,BICD 145,A01,651523,Murre; Cornelis,0,12,36,36
1717845479133,BIEB 102,A01,540371,Butler; Shannon Rhey,0,12,55,55
1717845479133,BIEB 102,A02,540479,Butler; Shannon Rhey,0,12,55,55
1717845479133,BIEB 102,A03,540480,Butler; Shannon Rhey,0,11,55,55
1717845479133,BIEB 102,A04,540483,Butler; Shannon Rhey,0,12,55,55
1717845479661,BIEB 121,A00,540485,Holway; David A.,0,14,32,32
1717845480188,BIEB 146,A01,540518,Petrie; Katherine Lynn,0,20,89,89
1717845480188,BIEB 146,A02,540520,Petrie; Katherine Lynn,0,21,89,89
1717845480188,BIEB 146,A03,540521,Petrie; Katherine Lynn,0,22,89,89
1717845480188,BIEB 146,A04,540522,Petrie; Katherine Lynn,0,22,88,88
1717845480720,BIEB 150,A01,540547,Rohner; Patrick Thomas,0,5,42,42
1717845480720,BIEB 150,A02,540677,Rohner; Patrick Thomas,0,6,42,42
1717845480720,BIEB 150,A03,540739,Rohner; Patrick Thomas,0,5,42,42
1717845480720,BIEB 150,A04,540899,Rohner; Patrick Thomas,0,6,42,42
1717845481251,BIEB 174,A01,540910,Cleland; Elsa Eleanor & Barton; Andrew David,23,0,43,20
1717845481251,BIEB 174,A02,540911,Cleland; Elsa Eleanor & Barton; Andrew David,16,0,43,27
1717845481251,BIEB 174,A03,540917,Cleland; Elsa Eleanor & Barton; Andrew David,14,0,43,29
1717845481251,BIEB 174,A04,540918,Cleland; Elsa Eleanor & Barton; Andrew David,11,0,43,32
1717845481780,BIEB 176,A01,540924,De Silva; Shermin,0,5,31,31
1717845481780,BIEB 176,A02,540926,De Silva; Shermin,0,4,31,31
1717845481780,BIEB 176,A03,540928,De Silva; Shermin,0,5,31,31
1717845481780,BIEB 176,A04,540929,De Silva; Shermin,0,5,31,31
